Posting Date,Document,Doc. Row,Whse,G/L Acct/BP Name,Inventory UoM,Qty,Price after Disc.,Balance
RM2000,,,,2-Row Barley - Silo - Malteurop,,,,"29,069"
01/03/2017,SO 18945,2,A1,Inventory - Raw Materials (CORP),lb,-695,$0.36,"28,374"
01/03/2017,SO 18947,2,A1,Inventory - Raw Materials (CORP),lb,-113,$0.36,"28,261"
01/04/2017,SO 18948,2,A1,Inventory - Raw Materials (CORP),lb,-695,$0.36,"27,566"
01/04/2017,SO 18950,2,A1,Inventory - Raw Materials (CORP),lb,-113,$0.36,"27,453"
01/05/2017,SO 18952,2,A1,Inventory - Raw Materials (CORP),lb,-335,$0.36,"27,118"
01/05/2017,SO 18987,2,A1,Inventory - Raw Materials (CORP),lb,-335,$0.36,"26,783"
01/05/2017,SO 18989,2,A1,Inventory - Raw Materials (CORP),lb,-335,$0.36,"26,448"
01/05/2017,SO 18991,2,A1,Inventory - Raw Materials (CORP),lb,-335,$0.36,"26,113"
01/06/2017,SO 18994,2,A1,Inventory - Raw Materials (CORP),lb,-335,$0.36,"25,778"
01/06/2017,SO 18997,2,A1,Inventory - Raw Materials (CORP),lb,-335,$0.36,"25,443"
01/09/2017,SO 19004,2,A1,Inventory - Raw Materials (CORP),lb,-335,$0.36,"25,108"
01/09/2017,SO 19007,2,A1,Inventory - Raw Materials (CORP),lb,-335,$0.36,"24,773"
01/09/2017,SO 19010,2,A1,Inventory - Raw Materials (CORP),lb,-335,$0.36,"24,438"
01/10/2017,SO 19012,2,A1,Inventory - Raw Materials (CORP),lb,-335,$0.36,"24,103"
01/11/2017,SO 19022,2,A1,Inventory - Raw Materials (CORP),lb,-335,$0.36,"23,768"
01/12/2017,SO 19024,2,A1,Inventory - Raw Materials (CORP),lb,-369,$0.36,"23,399"
01/12/2017,SO 19026,2,A1,Inventory - Raw Materials (CORP),lb,-369,$0.36,"23,030"
01/12/2017,SO 19071,2,A1,Inventory - Raw Materials (CORP),lb,-369,$0.36,"22,661"
01/13/2017,SO 19098,2,A1,Inventory - Raw Materials (CORP),lb,-476,$0.36,"22,185"
01/13/2017,SO 19100,2,A1,Inventory - Raw Materials (CORP),lb,-695,$0.36,"21,490"
01/13/2017,SO 19110,2,A1,Inventory - Raw Materials (CORP),lb,-695,$0.36,"20,795"
01/14/2017,SO 19112,2,A1,Inventory - Raw Materials (CORP),lb,-476,$0.36,"20,319"
01/16/2017,SO 19122,2,A1,Inventory - Raw Materials (CORP),lb,-369,$0.36,"19,950"
01/16/2017,SO 19124,2,A1,Inventory - Raw Materials (CORP),lb,-369,$0.36,"19,581"
01/16/2017,PU 10303,1,A1,North Country Malt Supply,lb,,$0.34,"19,581"
01/16/2017,SO 19132,2,A1,Inventory - Raw Materials (CORP),lb,-369,$0.69,"19,212"
01/17/2017,SO 19135,2,A1,Inventory - Raw Materials (CORP),lb,-369,$0.69,"18,843"
01/19/2017,SO 19151,1,A1,Inventory - Raw Materials (CORP),lb,-547,$0.69,"18,296"
01/19/2017,SO 19153,1,A1,Inventory - Raw Materials (CORP),lb,-547,$0.69,"17,749.00"
01/20/2017,SO 19160,2,A1,Inventory - Raw Materials (CORP),lb,-369,$0.69,"17,380"
01/20/2017,SO 19164,2,A1,Inventory - Raw Materials (CORP),lb,-369,$0.69,"17,011"
01/25/2017,SO 19202,2,A1,Inventory - Raw Materials (CORP),lb,-695,$0.69,"16,316"
01/25/2017,SO 19209,2,A1,Inventory - Raw Materials (CORP),lb,-695,$0.69,"15,621"
01/25/2017,SO 19260,2,A1,Inventory - Raw Materials (CORP),lb,"-1,398",$0.69,"14,223"
01/26/2017,SO 19212,2,A1,Inventory - Raw Materials (CORP),lb,-695,$0.69,"13,528"
01/26/2017,SO 19226,2,A1,Inventory - Raw Materials (CORP),lb,-695,$0.69,"12,833"
01/26/2017,SO 19228,2,A1,Inventory - Raw Materials (CORP),lb,-886,$0.69,"11,947"
01/26/2017,SO 19230,2,A1,Inventory - Raw Materials (CORP),lb,"-1,398",$0.69,"10,549"
01/26/2017,SO 19232,2,A1,Inventory - Raw Materials (CORP),lb,-886,$0.69,"9,663"
01/27/2017,SO 19234,2,A1,Inventory - Raw Materials (CORP),lb,-886,$0.69,"8,777"
01/27/2017,SO 19264,2,A1,Inventory - Raw Materials (CORP),lb,-886,$0.69,"7,891"
01/30/2017,SO 19270,2,A1,Inventory - Raw Materials (CORP),lb,-335,$0.69,"7,556"
01/30/2017,SO 19280,2,A1,Inventory - Raw Materials (CORP),lb,-335,$0.69,"7,221"
01/31/2017,SO 19299,2,A1,Inventory - Raw Materials (CORP),lb,-695,$0.69,"6,526"
02/01/2017,SO 19303,2,A1,Inventory - Raw Materials (CORP),lb,-695,$0.69,"5,831"
02/01/2017,SO 19318,2,A1,Inventory - Raw Materials (CORP),lb,-695,$0.69,"5,136"
02/02/2017,SO 19325,2,A1,Inventory - Raw Materials (CORP),lb,-695,$0.69,"4,441"
02/03/2017,SO 19363,2,A1,Inventory - Raw Materials (CORP),lb,-796,$0.69,"3,645"
02/03/2017,SO 19365,2,A1,Inventory - Raw Materials (CORP),lb,-796,$0.69,"2,849"
02/06/2017,SO 19372,2,A1,Inventory - Raw Materials (CORP),lb,-335,$0.69,"2,514"
02/06/2017,PD 10121,1,A1,Country Malt Group,lb,"47,640",$0.00,"50,154"
02/06/2017,SO 19375,2,A1,Inventory - Raw Materials (CORP),lb,-886,$0.03,"49,268"
02/06/2017,SO 19381,2,A1,Inventory - Raw Materials (CORP),lb,-335,$0.03,"48,933"
02/07/2017,SO 19383,2,A1,Inventory - Raw Materials (CORP),lb,-886,$0.03,"48,047"
02/07/2017,SO 19387,2,A1,Inventory - Raw Materials (CORP),lb,-407,$0.03,"47,640"
02/07/2017,SO 19387,3,A1,Inventory - Raw Materials (CORP),lb,-479,$0.03,"47,161"
02/07/2017,SO 19394,2,A1,Inventory - Raw Materials (CORP),lb,-886,$0.03,"46,275"
02/08/2017,SO 19397,2,A1,Inventory - Raw Materials (CORP),lb,-695,$0.03,"45,580"
02/08/2017,SO 19403,2,A1,Inventory - Raw Materials (CORP),lb,-886,$0.03,"44,694"
02/08/2017,PU 10344,1,A1,Country Malt Group,lb,,$0.33,"44,694"
02/08/2017,SO 19416,2,A1,Inventory - Raw Materials (CORP),lb,-695,$0.37,"43,999"
02/08/2017,SO 19418,2,A1,Inventory - Raw Materials (CORP),lb,-886,$0.37,"43,113"
02/08/2017,SO 19420,2,A1,Inventory - Raw Materials (CORP),lb,-796,$0.37,"42,317"
02/09/2017,SO 19426,2,A1,Inventory - Raw Materials (CORP),lb,-796,$0.37,"41,521"
02/09/2017,SO 19430,2,A1,Inventory - Raw Materials (CORP),lb,-796,$0.37,"40,725"
02/10/2017,SO 19448,2,A1,Inventory - Raw Materials (CORP),lb,-796,$0.37,"39,929"
02/10/2017,SO 19451,2,A1,Inventory - Raw Materials (CORP),lb,-796,$0.37,"39,133"
02/10/2017,SO 19454,2,A1,Inventory - Raw Materials (CORP),lb,-796,$0.37,"38,337"
02/13/2017,SO 19457,2,A1,Inventory - Raw Materials (CORP),lb,-335,$0.37,"38,002"
02/13/2017,SO 19462,2,A1,Inventory - Raw Materials (CORP),lb,-335,$0.37,"37,667"
02/13/2017,SO 19464,2,A1,Inventory - Raw Materials (CORP),lb,-335,$0.37,"37,332"
02/14/2017,SO 19470,2,A1,Inventory - Raw Materials (CORP),lb,-335,$0.37,"36,997"
02/14/2017,SO 19472,2,A1,Inventory - Raw Materials (CORP),lb,-796,$0.37,"36,201"
02/14/2017,SO 19473,2,A1,Inventory - Raw Materials (CORP),lb,-585,$0.37,"35,616"
02/14/2017,SO 19484,2,A1,Inventory - Raw Materials (CORP),lb,-796,$0.37,"34,820"
02/14/2017,SO 19485,2,A1,Inventory - Raw Materials (CORP),lb,-585,$0.37,"34,235"
02/16/2017,SO 19524,2,A1,Inventory - Raw Materials (CORP),lb,-695,$0.37,"33,540"
02/16/2017,SO 19538,2,A1,Inventory - Raw Materials (CORP),lb,-695,$0.37,"32,845"
02/16/2017,SO 19540,2,A1,Inventory - Raw Materials (CORP),lb,-695,$0.37,"32,150"
02/17/2017,SO 19543,2,A1,Inventory - Raw Materials (CORP),lb,-695,$0.37,"31,455"
02/17/2017,SO 19545,2,A1,Inventory - Raw Materials (CORP),lb,-113,$0.37,"31,342"
02/17/2017,SO 19557,2,A1,Inventory - Raw Materials (CORP),lb,-335,$0.37,"31,007"
02/18/2017,SO 19559,2,A1,Inventory - Raw Materials (CORP),lb,-335,$0.37,"30,672"
02/20/2017,SO 19563,2,A1,Inventory - Raw Materials (CORP),lb,-796,$0.37,"29,876"
02/20/2017,SO 19565,2,A1,Inventory - Raw Materials (CORP),lb,-113,$0.37,"29,763"
02/20/2017,SO 19567,2,A1,Inventory - Raw Materials (CORP),lb,-796,$0.37,"28,967"
02/20/2017,SO 19569,2,A1,Inventory - Raw Materials (CORP),lb,-796,$0.37,"28,171"
02/20/2017,SO 19571,2,A1,Inventory - Raw Materials (CORP),lb,-796,$0.37,"27,375"
02/21/2017,SO 19576,2,A1,Inventory - Raw Materials (CORP),lb,-695,$0.37,"26,680"
02/21/2017,SO 19596,2,A1,Inventory - Raw Materials (CORP),lb,-695,$0.37,"25,985"
02/23/2017,SO 19616,2,A1,Inventory - Raw Materials (CORP),lb,-335,$0.37,"25,650"
02/23/2017,SO 19621,2,A1,Inventory - Raw Materials (CORP),lb,-335,$0.37,"25,315"
02/24/2017,SO 19625,2,A1,Inventory - Raw Materials (CORP),lb,-335,$0.37,"24,980"
02/24/2017,SO 19627,2,A1,Inventory - Raw Materials (CORP),lb,-335,$0.37,"24,645"
02/24/2017,SO 19629,2,A1,Inventory - Raw Materials (CORP),lb,-796,$0.37,"23,849"
02/24/2017,SO 19631,2,A1,Inventory - Raw Materials (CORP),lb,-695,$0.37,"23,154"
02/24/2017,SO 19639,3,A1,Inventory - Raw Materials (CORP),lb,-796,$0.37,"22,358"
02/25/2017,SO 19641,2,A1,Inventory - Raw Materials (CORP),lb,-695,$0.37,"21,663"
02/27/2017,SO 19646,2,A1,Inventory - Raw Materials (CORP),lb,-335,$0.37,"21,328"
02/27/2017,SO 19652,2,A1,Inventory - Raw Materials (CORP),lb,-335,$0.37,"20,993"
02/27/2017,SO 19657,2,A1,Inventory - Raw Materials (CORP),lb,-335,$0.37,"20,658"
02/28/2017,SO 19660,2,A1,Inventory - Raw Materials (CORP),lb,-335,$0.37,"20,323"
03/01/2017,SO 19693,2,A1,Inventory - Raw Materials (CORP),lb,-695,$0.37,"19,628"
03/02/2017,SO 19695,2,A1,Inventory - Raw Materials (CORP),lb,-335,$0.37,"19,293"
03/02/2017,SO 19699,2,A1,Inventory - Raw Materials (CORP),lb,-695,$0.37,"18,598"
03/02/2017,SO 19709,2,A1,Inventory - Raw Materials (CORP),lb,-335,$0.37,"18,263"
03/02/2017,SO 19715,2,A1,Inventory - Raw Materials (CORP),lb,-796,$0.37,"17,467"
03/03/2017,SO 19731,2,A1,Inventory - Raw Materials (CORP),lb,-796,$0.37,"16,671"
03/06/2017,SO 19737,2,A1,Inventory - Raw Materials (CORP),lb,-796,$0.37,"15,875"
03/06/2017,SO 19748,2,A1,Inventory - Raw Materials (CORP),lb,-796,$0.37,"15,079"
03/07/2017,SO 19750,2,A1,Inventory - Raw Materials (CORP),lb,-796,$0.37,"14,283"
03/07/2017,SO 19754,2,A1,Inventory - Raw Materials (CORP),lb,-796,$0.37,"13,487"
03/07/2017,SO 19757,2,A1,Inventory - Raw Materials (CORP),lb,-796,$0.37,"12,691"
03/07/2017,SO 19765,2,A1,Inventory - Raw Materials (CORP),lb,-796,$0.37,"11,895"
03/08/2017,SO 19776,2,A1,Inventory - Raw Materials (CORP),lb,-695,$0.37,"11,200"
03/08/2017,SO 19787,2,A1,Inventory - Raw Materials (CORP),lb,-695,$0.37,"10,505"
03/09/2017,SO 19791,2,A1,Inventory - Raw Materials (CORP),lb,-695,$0.37,"9,810"
03/09/2017,SO 19794,2,A1,Inventory - Raw Materials (CORP),lb,-695,$0.37,"9,115"
03/12/2017,SO 19827,2,A1,Inventory - Raw Materials (CORP),lb,-796,$0.37,"8,319"
03/13/2017,SO 19832,2,A1,Inventory - Raw Materials (CORP),lb,-796,$0.37,"7,523"
03/13/2017,SO 19840,2,A1,Inventory - Raw Materials (CORP),lb,-796,$0.37,"6,727"
03/13/2017,SO 19844,2,A1,Inventory - Raw Materials (CORP),lb,-796,$0.37,"5,931"
03/15/2017,SO 19849,2,A1,Inventory - Raw Materials (CORP),lb,-113,$0.37,"5,818"
03/15/2017,SO 19854,2,A1,Inventory - Raw Materials (CORP),lb,-695,$0.37,"5,123"
03/15/2017,SO 19867,2,A1,Inventory - Raw Materials (CORP),lb,-113,$0.37,"5,010"
03/16/2017,SO 19870,2,A1,Inventory - Raw Materials (CORP),lb,-695,$0.37,"4,315"
03/16/2017,SO 19881,2,A1,Inventory - Raw Materials (CORP),lb,-335,$0.37,"3,980"
03/16/2017,SO 19895,2,A1,Inventory - Raw Materials (CORP),lb,-335,$0.37,"3,645"
03/20/2017,SO 19933,2,A1,Inventory - Raw Materials (CORP),lb,-796,$0.37,"2,849"
03/20/2017,SO 19941,2,A1,Inventory - Raw Materials (CORP),lb,-796,$0.37,"2,053"
03/21/2017,SO 19944,2,A1,Inventory - Raw Materials (CORP),lb,-796,$0.37,"1,257"
03/21/2017,SO 19954,2,A1,Inventory - Raw Materials (CORP),lb,-796,$0.37,461
03/21/2017,SO 19956,2,A1,Inventory - Raw Materials (CORP),lb,-335,$0.37,126
03/22/2017,SO 19973,2,A1,Inventory - Raw Materials (CORP),lb,-126,$0.37,
03/23/2017,PD 10136,1,A1,Country Malt Group,lb,"47,000",$0.00,"47,000"
03/23/2017,PU 10385,1,A1,Country Malt Group,lb,,$0.33,"47,000"
03/24/2017,SO 19995,3,A1,WIP - Wort (CORP),lb,-796,$0.00,"46,204"
03/24/2017,SO 20003,2,A1,WIP - Wort (CORP),lb,-796,$0.00,"45,408"
03/24/2017,SO 20006,2,A1,WIP - Wort (CORP),lb,-813,$0.00,"44,595"
03/25/2017,SO 20008,2,A1,WIP - Wort (CORP),lb,-813,$0.00,"43,782"
03/26/2017,SO 20011,2,A1,WIP - Wort (CORP),lb,-695,$0.00,"43,087"
03/27/2017,SO 20013,2,A1,WIP - Wort (CORP),lb,-695,$0.00,"42,392"
03/27/2017,SO 20015,2,A1,WIP - Wort (CORP),lb,-796,$0.00,"41,596"
03/27/2017,SO 20039,2,A1,WIP - Wort (CORP),lb,-796,$0.00,"40,800"
03/27/2017,SO 20042,2,A1,WIP - Wort (CORP),lb,-796,$0.00,"40,004"
03/28/2017,SO 20047,2,A1,WIP - Wort (CORP),lb,-796,$0.00,"39,208"
03/28/2017,SO 20062,2,A1,Inventory - Raw Materials (CORP),lb,-796,$0.33,"38,412"
03/29/2017,SO 20067,2,A1,Inventory - Raw Materials (CORP),lb,-796,$0.33,"37,616"
03/29/2017,SO 20079,2,A1,Inventory - Raw Materials (CORP),lb,-335,$0.33,"37,281"
03/30/2017,SO 20082,2,A1,Inventory - Raw Materials (CORP),lb,-335,$0.33,"36,946"
03/30/2017,SO 20084,2,A1,Inventory - Raw Materials (CORP),lb,-335,$0.33,"36,611"
03/30/2017,SO 20101,2,A1,Inventory - Raw Materials (CORP),lb,-335,$0.33,"36,276"
03/30/2017,SO 20116,2,A1,Inventory - Raw Materials (CORP),lb,-695,$0.33,"35,581"
04/02/2017,SO 20137,2,A1,Inventory - Raw Materials (CORP),lb,-335,$0.33,"35,246"
04/03/2017,SO 20146,2,A1,Inventory - Raw Materials (CORP),lb,-335,$0.33,"34,911"
04/03/2017,SO 20159,2,A1,Inventory - Raw Materials (CORP),lb,-796,$0.33,"34,115"
04/03/2017,SO 20161,2,A1,Inventory - Raw Materials (CORP),lb,-796,$0.33,"33,319"
04/04/2017,SO 20182,2,A1,Inventory - Raw Materials (CORP),lb,-695,$0.33,"32,624"
04/04/2017,SO 20186,2,A1,Inventory - Raw Materials (CORP),lb,-695,$0.33,"31,929"
04/04/2017,SO 20188,2,A1,Inventory - Raw Materials (CORP),lb,-796,$0.33,"31,133"
04/05/2017,SO 20191,2,A1,Inventory - Raw Materials (CORP),lb,-796,$0.33,"30,337"
04/05/2017,SO 20196,2,A1,Inventory - Raw Materials (CORP),lb,-796,$0.33,"29,541"
04/05/2017,SO 20213,2,A1,Inventory - Raw Materials (CORP),lb,-335,$0.33,"29,206"
04/05/2017,SO 20214,2,A1,Inventory - Raw Materials (CORP),lb,-796,$0.33,"28,410"
04/06/2017,SO 20216,2,A1,Inventory - Raw Materials (CORP),lb,-335,$0.33,"28,075"
04/06/2017,SO 20224,2,A1,Inventory - Raw Materials (CORP),lb,-796,$0.33,"27,279"
04/06/2017,SO 20232,2,A1,Inventory - Raw Materials (CORP),lb,-796,$0.33,"26,483"
04/07/2017,SO 20234,2,A1,Inventory - Raw Materials (CORP),lb,-796,$0.33,"25,687"
04/07/2017,SO 20238,2,A1,Inventory - Raw Materials (CORP),lb,-796,$0.33,"24,891"
04/10/2017,SO 20274,2,A1,Inventory - Raw Materials (CORP),lb,-796,$0.33,"24,095"
04/10/2017,SO 20276,2,A1,Inventory - Raw Materials (CORP),lb,-796,$0.33,"23,299"
04/10/2017,SO 20287,2,A1,Inventory - Raw Materials (CORP),lb,-796,$0.33,"22,503"
04/11/2017,SO 20294,2,A1,Inventory - Raw Materials (CORP),lb,-796,$0.33,"21,707"
04/11/2017,SO 20299,2,A1,Inventory - Raw Materials (CORP),lb,-695,$0.33,"21,012"
04/12/2017,SO 20305,2,A1,Inventory - Raw Materials (CORP),lb,-695,$0.33,"20,317"
04/12/2017,SO 20306,2,A1,Inventory - Raw Materials (CORP),lb,-335,$0.33,"19,982"
04/12/2017,SO 20320,3,A1,Inventory - Raw Materials (CORP),lb,-335,$0.33,"19,647"
04/13/2017,SO 20322,2,A1,Inventory - Raw Materials (CORP),lb,-796,$0.33,"18,851"
04/13/2017,SO 20324,2,A1,Inventory - Raw Materials (CORP),lb,-796,$0.33,"18,055"
04/13/2017,SO 20328,2,A1,Inventory - Raw Materials (CORP),lb,-796,$0.33,"17,259"
04/14/2017,SO 20330,2,A1,Inventory - Raw Materials (CORP),lb,-796,$0.33,"16,463"
04/14/2017,SO 20352,2,A1,Inventory - Raw Materials (CORP),lb,-335,$0.33,"16,128"
04/15/2017,SO 20368,2,A1,Inventory - Raw Materials (CORP),lb,-335,$0.33,"15,793"
04/16/2017,SO 20371,2,A1,Inventory - Raw Materials (CORP),lb,-335,$0.33,"15,458"
04/17/2017,SO 20377,2,A1,Inventory - Raw Materials (CORP),lb,-335,$0.33,"15,123"
04/17/2017,SO 20394,2,A1,Inventory - Raw Materials (CORP),lb,-796,$0.33,"14,327"
04/17/2017,SO 20397,2,A1,Inventory - Raw Materials (CORP),lb,-796,$0.33,"13,531"
04/17/2017,SO 20403,2,A1,Inventory - Raw Materials (CORP),lb,-796,$0.33,"12,735"
04/18/2017,SO 20405,2,A1,Inventory - Raw Materials (CORP),lb,-796,$0.33,"11,939"
04/18/2017,SO 20407,2,A1,Inventory - Raw Materials (CORP),lb,-796,$0.33,"11,143"
04/18/2017,SO 20409,2,A1,Inventory - Raw Materials (CORP),lb,-335,$0.33,"10,808"
04/18/2017,SO 20413,2,A1,Inventory - Raw Materials (CORP),lb,-796,$0.33,"10,012"
04/19/2017,SO 20417,2,A1,Inventory - Raw Materials (CORP),lb,-335,$0.33,"9,677"
04/19/2017,SO 20420,2,A1,Inventory - Raw Materials (CORP),lb,-695,$0.33,"8,982"
04/19/2017,SO 20431,1,A1,Inventory - Raw Materials (CORP),lb,-771,$0.33,"8,211"
04/19/2017,SO 20433,2,A1,Inventory - Raw Materials (CORP),lb,-695,$0.33,"7,516"
04/20/2017,SO 20439,1,A1,Inventory - Raw Materials (CORP),lb,-771,$0.33,"6,745"
04/20/2017,SO 20442,2,A1,Inventory - Raw Materials (CORP),lb,-796,$0.33,"5,949"
04/21/2017,SO 20450,2,A1,Inventory - Raw Materials (CORP),lb,-796,$0.33,"5,153"
04/21/2017,SO 20467,2,A1,Inventory - Raw Materials (CORP),lb,-796,$0.33,"4,357"
04/21/2017,PD 10147,1,A1,Country Malt Group,lb,"49,880",$0.00,"54,237"
04/21/2017,SO 20469,2,A1,Inventory - Raw Materials (CORP),lb,-796,$0.03,"53,441"
04/21/2017,PU 10396,1,A1,Country Malt Group,lb,,$0.33,"53,441"
04/23/2017,SO 20534,12,A1,Inventory - Raw Materials (CORP),lb,-163,$0.03,"53,278"
04/24/2017,SO 20489,2,A1,Inventory - Raw Materials (CORP),lb,-796,$0.03,"52,482"
04/24/2017,SO 20512,2,A1,Inventory - Raw Materials (CORP),lb,-796,$0.03,"51,686"
04/24/2017,SO 20529,2,A1,Inventory - Raw Materials (CORP),lb,-796,$0.03,"50,890"
04/25/2017,SO 20531,2,A1,Inventory - Raw Materials (CORP),lb,-796,$0.03,"50,094"
04/25/2017,SO 20541,2,A1,Inventory - Raw Materials (CORP),lb,-214,$0.03,"49,880"
04/25/2017,SO 20541,3,A1,Inventory - Raw Materials (CORP),lb,-481,$0.03,"49,399"
04/25/2017,SO 20556,2,A1,Inventory - Raw Materials (CORP),lb,-335,$0.03,"49,064"
04/25/2017,SO 20562,2,A1,Inventory - Raw Materials (CORP),lb,-476,$0.03,"48,588"
04/26/2017,SO 20564,3,A1,Inventory - Raw Materials (CORP),lb,-335,$0.03,"48,253"
04/26/2017,SO 20581,2,A1,Inventory - Raw Materials (CORP),lb,-476,$0.36,"47,777"
04/26/2017,SO 20584,2,A1,Inventory - Raw Materials (CORP),lb,-796,$0.36,"46,981"
04/27/2017,SO 20586,2,A1,Inventory - Raw Materials (CORP),lb,-335,$0.36,"46,646"
04/27/2017,SO 20601,2,A1,Inventory - Raw Materials (CORP),lb,-796,$0.36,"45,850"
04/27/2017,SO 20604,2,A1,Inventory - Raw Materials (CORP),lb,-335,$0.36,"45,515"
04/28/2017,SO 20606,2,A1,Inventory - Raw Materials (CORP),lb,-796,$0.36,"44,719"
04/28/2017,SO 20610,2,A1,Inventory - Raw Materials (CORP),lb,-796,$0.36,"43,923"
04/29/2017,SO 20612,2,A1,Inventory - Raw Materials (CORP),lb,-796,$0.36,"43,127"
04/29/2017,SO 20614,2,A1,Inventory - Raw Materials (CORP),lb,-796,$0.36,"42,331"
05/01/2017,SO 20616,2,A1,Inventory - Raw Materials (CORP),lb,-335,$0.36,"41,996"
05/01/2017,SO 20645,2,A1,Inventory - Raw Materials (CORP),lb,-796,$0.36,"41,200"
05/01/2017,SO 20648,2,A1,Inventory - Raw Materials (CORP),lb,-796,$0.36,"40,404"
05/01/2017,SO 20651,2,A1,Inventory - Raw Materials (CORP),lb,-796,$0.36,"39,608"
05/01/2017,SO 20653,2,A1,Inventory - Raw Materials (CORP),lb,-796,$0.36,"38,812"
05/03/2017,SO 20684,2,A1,Inventory - Raw Materials (CORP),lb,-695,$0.36,"38,117"
05/03/2017,SO 20693,2,A1,Inventory - Raw Materials (CORP),lb,-695,$0.36,"37,422"
05/03/2017,SO 20704,2,A1,Inventory - Raw Materials (CORP),lb,-796,$0.36,"36,626"
05/04/2017,SO 20707,2,A1,Inventory - Raw Materials (CORP),lb,-796,$0.36,"35,830"
05/04/2017,SO 20725,2,A1,Inventory - Raw Materials (CORP),lb,-796,$0.36,"35,034"
05/04/2017,SO 20726,2,A1,Inventory - Raw Materials (CORP),lb,-796,$0.36,"34,238"
05/04/2017,SO 20727,2,A1,Inventory - Raw Materials (CORP),lb,-335,$0.36,"33,903"
05/04/2017,SO 20728,2,A1,Inventory - Raw Materials (CORP),lb,-335,$0.36,"33,568"
05/05/2017,SO 20736,2,A1,Inventory - Raw Materials (CORP),lb,-335,$0.36,"33,233"
05/05/2017,SO 20761,2,A1,Inventory - Raw Materials (CORP),lb,-335,$0.36,"32,898"
05/07/2017,SO 20745,2,A1,Inventory - Raw Materials (CORP),lb,-335,$0.36,"32,563"
05/08/2017,SO 20750,2,A1,Inventory - Raw Materials (CORP),lb,-796,$0.36,"31,767"
05/08/2017,SO 20765,2,A1,Inventory - Raw Materials (CORP),lb,-335,$0.36,"31,432"
05/08/2017,SO 20778,2,A1,Inventory - Raw Materials (CORP),lb,-796,$0.36,"30,636"
05/08/2017,SO 20780,2,A1,Inventory - Raw Materials (CORP),lb,-796,$0.36,"29,840"
05/08/2017,SO 20790,2,A1,Inventory - Raw Materials (CORP),lb,-695,$0.36,"29,145"
05/09/2017,SO 20794,2,A1,Inventory - Raw Materials (CORP),lb,-796,$0.36,"28,349"
05/09/2017,SO 20796,2,A1,Inventory - Raw Materials (CORP),lb,-695,$0.36,"27,654"
05/10/2017,SO 20807,2,A1,Inventory - Raw Materials (CORP),lb,-335,$0.36,"27,319"
05/10/2017,SO 20821,2,A1,Inventory - Raw Materials (CORP),lb,-335,$0.36,"26,984"
05/11/2017,SO 20836,2,A1,Inventory - Raw Materials (CORP),lb,-796,$0.36,"26,188"
05/11/2017,SO 20844,2,A1,Inventory - Raw Materials (CORP),lb,-796,$0.36,"25,392"
05/11/2017,SO 20846,2,A1,Inventory - Raw Materials (CORP),lb,-796,$0.36,"24,596"
05/11/2017,SO 20850,2,A1,Inventory - Raw Materials (CORP),lb,-796,$0.36,"23,800"
05/12/2017,SO 20848,2,A1,Inventory - Raw Materials (CORP),lb,-335,$0.36,"23,465"
05/12/2017,SO 20862,2,A1,Inventory - Raw Materials (CORP),lb,-796,$0.36,"22,669"
05/12/2017,SO 20864,2,A1,Inventory - Raw Materials (CORP),lb,-335,$0.36,"22,334"
05/12/2017,SO 20866,2,A1,Inventory - Raw Materials (CORP),lb,-796,$0.36,"21,538"
05/13/2017,SO 20950,3,A1,Inventory - Raw Materials (CORP),lb,-170,$0.36,"21,368"
05/15/2017,SO 20872,2,A1,Inventory - Raw Materials (CORP),lb,-695,$0.36,"20,673"
05/15/2017,SO 20893,2,A1,Inventory - Raw Materials (CORP),lb,-695,$0.36,"19,978"
05/15/2017,SO 20936,2,A1,Inventory - Raw Materials (CORP),lb,-796,$0.36,"19,182"
05/16/2017,SO 20912,2,A1,Inventory - Raw Materials (CORP),lb,-796,$0.36,"18,386"
05/16/2017,SO 20920,2,A1,Inventory - Raw Materials (CORP),lb,-796,$0.36,"17,590"
05/16/2017,SO 20922,2,A1,Inventory - Raw Materials (CORP),lb,-796,$0.36,"16,794"
05/17/2017,SO 20948,2,A1,Inventory - Raw Materials (CORP),lb,-796,$0.36,"15,998"
05/18/2017,SO 20971,2,A1,Inventory - Raw Materials (CORP),lb,-796,$0.36,"15,202"
05/18/2017,SO 20976,2,A1,Inventory - Raw Materials (CORP),lb,-335,$0.36,"14,867"
05/18/2017,SO 20994,2,A1,Inventory - Raw Materials (CORP),lb,-335,$0.36,"14,532"
05/18/2017,SO 20996,2,A1,Inventory - Raw Materials (CORP),lb,-335,$0.36,"14,197"
05/19/2017,SO 20999,2,A1,Inventory - Raw Materials (CORP),lb,-335,$0.36,"13,862"
05/22/2017,SO 21035,2,A1,Inventory - Raw Materials (CORP),lb,-796,$0.36,"13,066"
05/22/2017,SO 21056,2,A1,Inventory - Raw Materials (CORP),lb,-796,$0.36,"12,270"
05/22/2017,SO 21062,2,A1,Inventory - Raw Materials (CORP),lb,-796,$0.36,"11,474"
05/23/2017,SO 21071,2,A1,Inventory - Raw Materials (CORP),lb,-796,$0.36,"10,678"
05/23/2017,SO 21079,2,A1,Inventory - Raw Materials (CORP),lb,-695,$0.36,"9,983"
05/23/2017,SO 21093,2,A1,Inventory - Raw Materials (CORP),lb,-695,$0.36,"9,288"
05/24/2017,SO 21095,2,A1,Inventory - Raw Materials (CORP),lb,-335,$0.36,"8,953"
05/24/2017,SO 21102,2,A1,Inventory - Raw Materials (CORP),lb,-335,$0.36,"8,618"
05/24/2017,SO 21109,2,A1,Inventory - Raw Materials (CORP),lb,-335,$0.36,"8,283"
05/24/2017,SO 21112,2,A1,Inventory - Raw Materials (CORP),lb,-335,$0.36,"7,948"
05/25/2017,SO 21119,2,A1,Inventory - Raw Materials (CORP),lb,-335,$0.36,"7,613"
05/25/2017,SO 21123,2,A1,Inventory - Raw Materials (CORP),lb,-335,$0.36,"7,278"
05/26/2017,SO 21138,2,A1,Inventory - Raw Materials (CORP),lb,-796,$0.36,"6,482"
05/26/2017,SO 21140,2,A1,Inventory - Raw Materials (CORP),lb,-796,$0.36,"5,686"
05/26/2017,SO 21142,2,A1,Inventory - Raw Materials (CORP),lb,-796,$0.36,"4,890"
05/26/2017,SO 21159,2,A1,Inventory - Raw Materials (CORP),lb,-796,$0.36,"4,094"
05/30/2017,SO 21157,2,A1,Inventory - Raw Materials (CORP),lb,-695,$0.36,"3,399"
05/30/2017,PD 10155,1,A1,Country Malt Group,lb,"48,760",$0.00,"52,159"
05/30/2017,SO 21172,2,A1,Inventory - Raw Materials (CORP),lb,-695,$0.02,"51,464"
05/31/2017,SO 21182,2,A1,Inventory - Raw Materials (CORP),lb,-796,$0.02,"50,668"
05/31/2017,SO 21197,2,A1,Inventory - Raw Materials (CORP),lb,-796,$0.02,"49,872"
05/31/2017,SO 21200,2,A1,Inventory - Raw Materials (CORP),lb,-796,$0.02,"49,076"
06/01/2017,SO 21207,2,A1,Inventory - Raw Materials (CORP),lb,-316,$0.02,"48,760"
06/01/2017,SO 21207,3,A1,Inventory - Raw Materials (CORP),lb,-480,$0.02,"48,280"
06/01/2017,SO 21210,2,A1,Inventory - Raw Materials (CORP),lb,-796,$0.02,"47,484"
06/01/2017,SO 21224,2,A1,Inventory - Raw Materials (CORP),lb,-796,$0.02,"46,688"
06/01/2017,SO 21226,2,A1,Inventory - Raw Materials (CORP),lb,-796,$0.02,"45,892"
06/02/2017,SO 21232,2,A1,Inventory - Raw Materials (CORP),lb,-796,$0.02,"45,096"
06/02/2017,SO 21241,2,A1,Inventory - Raw Materials (CORP),lb,-335,$0.02,"44,761"
06/02/2017,PU 10420,1,A1,Country Malt Group,lb,,$0.33,"44,761"
06/02/2017,SO 21244,2,A1,Inventory - Raw Materials (CORP),lb,-335,$0.35,"44,426"
06/05/2017,SO 21251,2,A1,Inventory - Raw Materials (CORP),lb,-796,$0.35,"43,630"
06/05/2017,SO 21255,2,A1,Inventory - Raw Materials (CORP),lb,-796,$0.35,"42,834"
06/05/2017,SO 21264,2,A1,Inventory - Raw Materials (CORP),lb,-796,$0.35,"42,038"
06/05/2017,SO 21272,2,A1,Inventory - Raw Materials (CORP),lb,-796,$0.35,"41,242"
06/06/2017,SO 21277,2,A1,Inventory - Raw Materials (CORP),lb,-335,$0.35,"40,907"
06/06/2017,SO 21281,3,A1,Inventory - Raw Materials (CORP),lb,-695,$0.35,"40,212"
06/06/2017,SO 21283,2,A1,Inventory - Raw Materials (CORP),lb,-335,$0.35,"39,877"
06/06/2017,SO 21294,2,A1,Inventory - Raw Materials (CORP),lb,-695,$0.35,"39,182"
06/07/2017,SO 21306,2,A1,Inventory - Raw Materials (CORP),lb,-335,$0.35,"38,847"
06/07/2017,SO 21318,2,A1,Inventory - Raw Materials (CORP),lb,-335,$0.35,"38,512"
06/08/2017,SO 21323,2,A1,Inventory - Raw Materials (CORP),lb,-796,$0.35,"37,716"
06/08/2017,SO 21334,2,A1,Inventory - Raw Materials (CORP),lb,-796,$0.35,"36,920"
06/08/2017,SO 21338,2,A1,Inventory - Raw Materials (CORP),lb,-796,$0.35,"36,124"
06/08/2017,SO 21340,2,A1,Inventory - Raw Materials (CORP),lb,-796,$0.35,"35,328"
06/09/2017,SO 21342,2,A1,Inventory - Raw Materials (CORP),lb,-475,$0.35,"34,853"
06/09/2017,SO 21353,2,A1,Inventory - Raw Materials (CORP),lb,-475,$0.35,"34,378"
06/11/2017,SO 21360,2,A1,Inventory - Raw Materials (CORP),lb,-335,$0.35,"34,043"
06/12/2017,SO 21363,2,A1,Inventory - Raw Materials (CORP),lb,-335,$0.35,"33,708"
06/12/2017,SO 21383,2,A1,Inventory - Raw Materials (CORP),lb,-796,$0.35,"32,912"
06/12/2017,SO 21386,2,A1,Inventory - Raw Materials (CORP),lb,-796,$0.35,"32,116"
06/12/2017,SO 21405,2,A1,Inventory - Raw Materials (CORP),lb,-796,$0.35,"31,320"
06/13/2017,SO 21388,2,A1,Inventory - Raw Materials (CORP),lb,-796,$0.35,"30,524"
06/13/2017,SO 21401,2,A1,Inventory - Raw Materials (CORP),lb,-796,$0.35,"29,728"
06/13/2017,SO 21411,2,A1,Inventory - Raw Materials (CORP),lb,-695,$0.35,"29,033"
06/13/2017,SO 21434,2,A1,Inventory - Raw Materials (CORP),lb,-796,$0.35,"28,237"
06/14/2017,SO 21420,2,A1,Inventory - Raw Materials (CORP),lb,-695,$0.35,"27,542"
06/14/2017,SO 21437,2,A1,Inventory - Raw Materials (CORP),lb,-796,$0.35,"26,746"
06/15/2017,SO 21432,2,A1,Inventory - Raw Materials (CORP),lb,-796,$0.35,"25,950"
06/15/2017,SO 21468,1,A1,Inventory - Raw Materials (CORP),lb,-771,$0.35,"25,179"
06/16/2017,SO 21473,1,A1,Inventory - Raw Materials (CORP),lb,-771,$0.35,"24,408"
06/16/2017,SO 21475,2,A1,Inventory - Raw Materials (CORP),lb,-335,$0.35,"24,073"
06/16/2017,SO 21480,2,A1,Inventory - Raw Materials (CORP),lb,-335,$0.35,"23,738"
06/16/2017,SO 21503,2,A1,Inventory - Raw Materials (CORP),lb,-335,$0.35,"23,403"
06/17/2017,SO 21482,2,A1,Inventory - Raw Materials (CORP),lb,-335,$0.35,"23,068"
06/18/2017,SO 21486,2,A1,Inventory - Raw Materials (CORP),lb,-796,$0.35,"22,272"
06/19/2017,SO 21488,2,A1,Inventory - Raw Materials (CORP),lb,-796,$0.35,"21,476"
06/19/2017,SO 21490,2,A1,Inventory - Raw Materials (CORP),lb,-796,$0.35,"20,680"
06/19/2017,SO 21507,2,A1,Inventory - Raw Materials (CORP),lb,-796,$0.35,"19,884"
06/20/2017,SO 21520,2,A1,Inventory - Raw Materials (CORP),lb,-695,$0.35,"19,189"
06/20/2017,SO 21521,2,A1,Inventory - Raw Materials (CORP),lb,-335,$0.35,"18,854"
06/20/2017,SO 21530,2,A1,Inventory - Raw Materials (CORP),lb,-335,$0.35,"18,519"
06/20/2017,SO 21537,2,A1,Inventory - Raw Materials (CORP),lb,-695,$0.35,"17,824"
06/22/2017,SO 21582,2,A1,Inventory - Raw Materials (CORP),lb,-335,$0.35,"17,489"
06/22/2017,SO 21601,2,A1,Inventory - Raw Materials (CORP),lb,-695,$0.35,"16,794"
06/22/2017,SO 21604,2,A1,Inventory - Raw Materials (CORP),lb,-695,$0.35,"16,099"
06/23/2017,SO 21608,2,A1,Inventory - Raw Materials (CORP),lb,-796,$0.35,"15,303"
06/23/2017,SO 21610,2,A1,Inventory - Raw Materials (CORP),lb,-796,$0.35,"14,507"
06/23/2017,SO 21619,2,A1,Inventory - Raw Materials (CORP),lb,-796,$0.35,"13,711"
06/23/2017,SO 21631,2,A1,Inventory - Raw Materials (CORP),lb,-796,$0.35,"12,915"
06/24/2017,SO 21633,2,A1,Inventory - Raw Materials (CORP),lb,-796,$0.35,"12,119"
06/25/2017,SO 21636,2,A1,Inventory - Raw Materials (CORP),lb,-796,$0.35,"11,323"
06/26/2017,SO 21639,2,A1,Inventory - Raw Materials (CORP),lb,-796,$0.35,"10,527"
06/26/2017,SO 21644,2,A1,Inventory - Raw Materials (CORP),lb,-796,$0.35,"9,731"
06/26/2017,SO 21646,2,A1,Inventory - Raw Materials (CORP),lb,-695,$0.35,"9,036"
06/26/2017,SO 21649,2,A1,Inventory - Raw Materials (CORP),lb,-695,$0.35,"8,341"
06/27/2017,SO 21654,2,A1,Inventory - Raw Materials (CORP),lb,-335,$0.35,"8,006"
06/27/2017,SO 21675,2,A1,Inventory - Raw Materials (CORP),lb,-335,$0.35,"7,671"
06/27/2017,SO 21724,2,A1,Inventory - Raw Materials (CORP),lb,-335,$0.35,"7,336"
06/28/2017,SO 21682,2,A1,Inventory - Raw Materials (CORP),lb,-335,$0.35,"7,001"
06/29/2017,SO 21713,3,A1,Inventory - Raw Materials (CORP),lb,-796,$0.35,"6,205"
06/29/2017,SO 21729,2,A1,Inventory - Raw Materials (CORP),lb,-796,$0.35,"5,409"
06/29/2017,PD 10175,1,A1,Country Malt Group,lb,"48,340",$0.00,"53,749"
06/29/2017,SO 21735,2,A1,Inventory - Raw Materials (CORP),lb,-796,$0.04,"52,953"
06/29/2017,SO 21739,2,A1,Inventory - Raw Materials (CORP),lb,-796,$0.04,"52,157"
06/30/2017,SO 21805,2,A1,Inventory - Raw Materials (CORP),lb,-335,$0.04,"51,822"
07/01/2017,SO 21806,2,A1,Inventory - Raw Materials (CORP),lb,-335,$0.04,"51,487"
07/02/2017,SO 21763,2,A1,Inventory - Raw Materials (CORP),lb,-796,$0.04,"50,691"
07/03/2017,SO 21765,2,A1,Inventory - Raw Materials (CORP),lb,-796,$0.04,"49,895"
07/03/2017,SO 21767,2,A1,Inventory - Raw Materials (CORP),lb,-796,$0.04,"49,099"
07/03/2017,SO 21773,2,A1,Inventory - Raw Materials (CORP),lb,-796,$0.04,"48,303"
07/03/2017,SO 21808,2,A1,Inventory - Raw Materials (CORP),lb,-796,$0.04,"47,507"
07/05/2017,SO 21777,2,A1,Inventory - Raw Materials (CORP),lb,-633,$0.04,"46,874"
07/05/2017,SO 21777,3,A1,Inventory - Raw Materials (CORP),lb,-163,$0.04,"46,711"
07/05/2017,SO 21812,2,A1,Inventory - Raw Materials (CORP),lb,-335,$0.04,"46,376"
07/05/2017,SO 21819,2,A1,Inventory - Raw Materials (CORP),lb,-695,$0.04,"45,681"
07/05/2017,SO 21825,2,A1,Inventory - Raw Materials (CORP),lb,-335,$0.04,"45,346"
07/06/2017,SO 21828,2,A1,Inventory - Raw Materials (CORP),lb,-695,$0.04,"44,651"
07/06/2017,SO 21847,2,A1,Inventory - Raw Materials (CORP),lb,-796,$0.04,"43,855"
07/06/2017,SO 21850,2,A1,Inventory - Raw Materials (CORP),lb,-796,$0.04,"43,059"
07/06/2017,SO 21853,2,A1,Inventory - Raw Materials (CORP),lb,-335,$0.04,"42,724"
07/07/2017,SO 21857,2,A1,Inventory - Raw Materials (CORP),lb,-335,$0.04,"42,389"
07/07/2017,PU 10447,1,A1,Country Malt Group,lb,,$0.33,"42,389"
07/09/2017,SO 21886,2,A1,Inventory - Raw Materials (CORP),lb,-347,$0.37,"42,042"
07/09/2017,SO 21887,2,A1,Inventory - Raw Materials (CORP),lb,-335,$0.37,"41,707"
07/10/2017,SO 21901,2,A1,Inventory - Raw Materials (CORP),lb,-796,$0.37,"40,911"
07/10/2017,SO 21904,2,A1,Inventory - Raw Materials (CORP),lb,-796,$0.37,"40,115"
07/10/2017,SO 21919,2,A1,Inventory - Raw Materials (CORP),lb,-796,$0.37,"39,319"
07/10/2017,SO 21926,2,A1,Inventory - Raw Materials (CORP),lb,-796,$0.37,"38,523"
07/11/2017,SO 21922,2,A1,Inventory - Raw Materials (CORP),lb,-695,$0.37,"37,828"
07/11/2017,SO 21928,2,A1,Inventory - Raw Materials (CORP),lb,-695,$0.37,"37,133"
07/11/2017,SO 21936,2,A1,Inventory - Raw Materials (CORP),lb,-796,$0.37,"36,337"
07/12/2017,SO 21945,2,A1,Inventory - Raw Materials (CORP),lb,-796,$0.37,"35,541"
07/14/2017,SO 21988,2,A1,Inventory - Raw Materials (CORP),lb,-335,$0.37,"35,206"
07/14/2017,SO 22018,2,A1,Inventory - Raw Materials (CORP),lb,-335,$0.37,"34,871"
07/15/2017,SO 21989,2,A1,Inventory - Raw Materials (CORP),lb,-335,$0.37,"34,536"
07/15/2017,SO 21991,2,A1,Inventory - Raw Materials (CORP),lb,-335,$0.37,"34,201"
07/16/2017,SO 21993,2,A1,Inventory - Raw Materials (CORP),lb,-335,$0.37,"33,866"
07/16/2017,SO 22019,2,A1,Inventory - Raw Materials (CORP),lb,-335,$0.37,"33,531"
07/17/2017,SO 21996,2,A1,Inventory - Raw Materials (CORP),lb,-335,$0.37,"33,196"
07/17/2017,SO 22023,2,A1,Inventory - Raw Materials (CORP),lb,-335,$0.37,"32,861"
07/17/2017,SO 22024,2,A1,Inventory - Raw Materials (CORP),lb,-796,$0.37,"32,065"
07/17/2017,SO 22029,2,A1,Inventory - Raw Materials (CORP),lb,-796,$0.37,"31,269"
07/18/2017,SO 22032,2,A1,Inventory - Raw Materials (CORP),lb,-796,$0.37,"30,473"
07/18/2017,SO 22050,2,A1,Inventory - Raw Materials (CORP),lb,-796,$0.37,"29,677"
07/19/2017,SO 22067,2,A1,Inventory - Raw Materials (CORP),lb,-335,$0.37,"29,342"
07/19/2017,SO 22068,2,A1,Inventory - Raw Materials (CORP),lb,-335,$0.37,"29,007"
07/19/2017,SO 22074,2,A1,Inventory - Raw Materials (CORP),lb,-335,$0.37,"28,672"
07/19/2017,SO 22076,2,A1,Inventory - Raw Materials (CORP),lb,-335,$0.37,"28,337"
07/20/2017,SO 22078,2,A1,Inventory - Raw Materials (CORP),lb,-335,$0.37,"28,002"
07/20/2017,SO 22081,2,A1,Inventory - Raw Materials (CORP),lb,-695,$0.37,"27,307"
07/20/2017,SO 22095,2,A1,Inventory - Raw Materials (CORP),lb,-695,$0.37,"26,612"
07/20/2017,SO 22097,2,A1,Inventory - Raw Materials (CORP),lb,-369,$0.37,"26,243"
07/20/2017,SO 22101,2,A1,Inventory - Raw Materials (CORP),lb,-796,$0.37,"25,447"
07/20/2017,SO 22145,1,A1,Inventory - Raw Materials (CORP),lb,-36,$0.37,"25,411"
07/21/2017,SO 22103,2,A1,Inventory - Raw Materials (CORP),lb,-301,$0.37,"25,110"
07/21/2017,SO 22106,2,A1,Inventory - Raw Materials (CORP),lb,-796,$0.37,"24,314"
07/21/2017,SO 22146,1,A1,Inventory - Raw Materials (CORP),lb,-36,$0.37,"24,278"
07/22/2017,SO 22115,2,A1,Inventory - Raw Materials (CORP),lb,-335,$0.37,"23,943"
07/23/2017,SO 22117,2,A1,Inventory - Raw Materials (CORP),lb,-335,$0.37,"23,608"
07/24/2017,SO 22164,2,A1,Inventory - Raw Materials (CORP),lb,-335,$0.37,"23,273"
07/25/2017,SO 22170,2,A1,Inventory - Raw Materials (CORP),lb,-335,$0.37,"22,938"
07/25/2017,SO 22172,2,A1,Inventory - Raw Materials (CORP),lb,-695,$0.37,"22,243"
07/25/2017,SO 22176,2,A1,Inventory - Raw Materials (CORP),lb,-585,$0.37,"21,658"
07/26/2017,SO 22179,2,A1,Inventory - Raw Materials (CORP),lb,-695,$0.37,"20,963"
07/26/2017,SO 22197,2,A1,Inventory - Raw Materials (CORP),lb,-475,$0.37,"20,488"
07/26/2017,SO 22206,2,A1,Inventory - Raw Materials (CORP),lb,-796,$0.37,"19,692"
07/27/2017,SO 22200,2,A1,Inventory - Raw Materials (CORP),lb,-796,$0.37,"18,896"
07/27/2017,SO 22203,2,A1,Inventory - Raw Materials (CORP),lb,-796,$0.37,"18,100"
07/27/2017,SO 22208,2,A1,Inventory - Raw Materials (CORP),lb,-796,$0.37,"17,304"
07/28/2017,SO 22265,3,A1,Inventory - Raw Materials (CORP),lb,-77,$0.37,"17,227"
07/31/2017,SO 22237,3,A1,Inventory - Raw Materials (CORP),lb,-77,$0.37,"17,150"
07/31/2017,SO 22246,2,A1,Inventory - Raw Materials (CORP),lb,-335,$0.37,"16,815"
08/01/2017,SO 22249,2,A1,Inventory - Raw Materials (CORP),lb,-695,$0.37,"16,120"
08/01/2017,SO 22251,2,A1,Inventory - Raw Materials (CORP),lb,-335,$0.37,"15,785"
08/01/2017,SO 22267,2,A1,Inventory - Raw Materials (CORP),lb,-695,$0.37,"15,090"
08/02/2017,SO 22299,2,A1,Inventory - Raw Materials (CORP),lb,-335,$0.37,"14,755"
08/02/2017,SO 22308,2,A1,Inventory - Raw Materials (CORP),lb,-335,$0.37,"14,420"
08/03/2017,SO 22310,2,A1,Inventory - Raw Materials (CORP),lb,-335,$0.37,"14,085"
08/03/2017,SO 22317,2,A1,Inventory - Raw Materials (CORP),lb,-335,$0.37,"13,750"
08/03/2017,SO 22319,2,A1,Inventory - Raw Materials (CORP),lb,-796,$0.37,"12,954"
08/03/2017,SO 22321,2,A1,Inventory - Raw Materials (CORP),lb,-796,$0.37,"12,158"
08/04/2017,SO 22323,2,A1,Inventory - Raw Materials (CORP),lb,-796,$0.37,"11,362"
08/04/2017,SO 22324,2,A1,Inventory - Raw Materials (CORP),lb,-796,$0.37,"10,566"
08/04/2017,SO 22327,2,A1,Inventory - Raw Materials (CORP),lb,-796,$0.37,"9,770"
08/04/2017,SO 22329,2,A1,Inventory - Raw Materials (CORP),lb,-335,$0.37,"9,435"
08/04/2017,SO 22335,2,A1,Inventory - Raw Materials (CORP),lb,-335,$0.37,"9,100"
08/05/2017,SO 22339,2,A1,Inventory - Raw Materials (CORP),lb,-335,$0.37,"8,765"
08/05/2017,SO 22348,2,A1,Inventory - Raw Materials (CORP),lb,-335,$0.37,"8,430"
08/06/2017,SO 22341,2,A1,Inventory - Raw Materials (CORP),lb,-475,$0.37,"7,955"
08/06/2017,SO 22353,2,A1,Inventory - Raw Materials (CORP),lb,-695,$0.37,"7,260"
08/06/2017,SO 22354,2,A1,Inventory - Raw Materials (CORP),lb,-475,$0.37,"6,785"
08/07/2017,SO 22351,2,A1,Inventory - Raw Materials (CORP),lb,-695,$0.37,"6,090"
08/09/2017,SO 22405,2,A1,Inventory - Raw Materials (CORP),lb,-796,$0.37,"5,294"
08/09/2017,SO 22415,2,A1,Inventory - Raw Materials (CORP),lb,-796,$0.37,"4,498"
08/09/2017,SO 22419,2,A1,Inventory - Raw Materials (CORP),lb,-796,$0.37,"3,702"
08/09/2017,SO 22421,2,A1,Inventory - Raw Materials (CORP),lb,-796,$0.37,"2,906"
08/11/2017,SO 22441,2,A1,Inventory - Raw Materials (CORP),lb,-335,$0.37,"2,571"
08/11/2017,SO 22453,2,A1,Inventory - Raw Materials (CORP),lb,-335,$0.37,"2,236"
08/13/2017,SO 22465,2,A1,Inventory - Raw Materials (CORP),lb,-796,$0.37,"1,440"
08/14/2017,SO 22461,2,A1,Inventory - Raw Materials (CORP),lb,-796,$0.37,644
08/14/2017,SO 22478,2,A1,Inventory - Raw Materials (CORP),lb,-551,$0.37,93
08/15/2017,ST 133,2,A1,Inventory - Raw Materials (CORP),lb,-93,$0.37,
08/15/2017,PD 10198,1,A1,Country Malt Group,lb,"47,340",$0.00,"47,340"
08/16/2017,SO 22527,2,A1,WIP - Wort (CORP),lb,-695,$0.00,"46,645"
08/16/2017,PU 10490,1,A1,Country Malt Group,lb,,$0.33,"46,645"
08/17/2017,SO 22530,2,A1,WIP - Wort (CORP),lb,-695,$0.00,"45,950"
08/17/2017,SO 22552,2,A1,WIP - Wort (CORP),lb,-335,$0.00,"45,615"
08/18/2017,SO 22556,2,A1,WIP - Wort (CORP),lb,-335,$0.00,"45,280"
08/18/2017,SO 22565,2,A1,WIP - Wort (CORP),lb,-335,$0.00,"44,945"
08/18/2017,SO 22570,2,A1,WIP - Wort (CORP),lb,-335,$0.00,"44,610"
08/19/2017,SO 22607,2,A1,WIP - Wort (CORP),lb,-796,$0.00,"43,814"
08/19/2017,SO 22608,2,A1,WIP - Wort (CORP),lb,-796,$0.00,"43,018"
08/22/2017,SO 22598,2,A1,WIP - Wort (CORP),lb,-335,$0.00,"42,683"
08/22/2017,SO 22600,2,A1,WIP - Wort (CORP),lb,-335,$0.00,"42,348"
08/23/2017,SO 22604,2,A1,WIP - Wort (CORP),lb,-335,$0.00,"42,013"
08/23/2017,SO 22650,2,A1,Inventory - Raw Materials (CORP),lb,-335,$0.33,"41,678"
08/24/2017,SO 22651,2,A1,Inventory - Raw Materials (CORP),lb,-796,$0.33,"40,882"
08/24/2017,SO 22652,2,A1,Inventory - Raw Materials (CORP),lb,-796,$0.33,"40,086"
08/24/2017,SO 22653,2,A1,Inventory - Raw Materials (CORP),lb,-796,$0.33,"39,290"
08/25/2017,SO 22654,2,A1,Inventory - Raw Materials (CORP),lb,-796,$0.33,"38,494"
08/25/2017,SO 22698,2,A1,Inventory - Raw Materials (CORP),lb,-695,$0.33,"37,799"
08/26/2017,SO 22699,2,A1,Inventory - Raw Materials (CORP),lb,-335,$0.33,"37,464"
08/27/2017,SO 22700,2,A1,Inventory - Raw Materials (CORP),lb,-335,$0.33,"37,129"
08/27/2017,SO 22701,2,A1,Inventory - Raw Materials (CORP),lb,-335,$0.33,"36,794"
08/28/2017,SO 22702,2,A1,Inventory - Raw Materials (CORP),lb,-335,$0.33,"36,459"
08/28/2017,SO 22703,2,A1,Inventory - Raw Materials (CORP),lb,-796,$0.33,"35,663"
08/28/2017,SO 22704,2,A1,Inventory - Raw Materials (CORP),lb,-796,$0.33,"34,867"
08/28/2017,SO 22705,2,A1,Inventory - Raw Materials (CORP),lb,-796,$0.33,"34,071"
08/29/2017,SO 22706,2,A1,Inventory - Raw Materials (CORP),lb,-796,$0.33,"33,275"
08/30/2017,SO 22737,2,A1,Inventory - Raw Materials (CORP),lb,-796,$0.33,"32,479"
08/31/2017,SO 22739,2,A1,Inventory - Raw Materials (CORP),lb,-796,$0.33,"31,683"
08/31/2017,SO 22757,2,A1,Inventory - Raw Materials (CORP),lb,-335,$0.33,"31,348"
08/31/2017,SO 22759,2,A1,Inventory - Raw Materials (CORP),lb,-335,$0.33,"31,013"
08/31/2017,SO 22765,2,A1,Inventory - Raw Materials (CORP),lb,-335,$0.33,"30,678"
09/01/2017,SO 22771,2,A1,Inventory - Raw Materials (CORP),lb,-335,$0.33,"30,343"
09/01/2017,SO 22773,2,A1,Inventory - Raw Materials (CORP),lb,-695,$0.33,"29,648"
09/01/2017,SO 22778,2,A1,Inventory - Raw Materials (CORP),lb,-695,$0.33,"28,953"
09/05/2017,SO 22828,2,A1,Inventory - Raw Materials (CORP),lb,-796,$0.33,"28,157"
09/05/2017,SO 22830,2,A1,Inventory - Raw Materials (CORP),lb,-796,$0.33,"27,361"
09/06/2017,SO 22843,2,A1,Inventory - Raw Materials (CORP),lb,-796,$0.33,"26,565"
09/06/2017,SO 22867,2,A1,Inventory - Raw Materials (CORP),lb,-695,$0.33,"25,870"
09/07/2017,SO 22845,2,A1,Inventory - Raw Materials (CORP),lb,-695,$0.33,"25,175"
09/07/2017,SO 22865,2,A1,Inventory - Raw Materials (CORP),lb,-335,$0.33,"24,840"
09/07/2017,SO 22868,2,A1,Inventory - Raw Materials (CORP),lb,-796,$0.33,"24,044"
09/07/2017,SO 22878,2,A1,Inventory - Raw Materials (CORP),lb,-335,$0.33,"23,709"
09/08/2017,SO 22881,2,A1,Inventory - Raw Materials (CORP),lb,-335,$0.33,"23,374"
09/08/2017,SO 22895,2,A1,Inventory - Raw Materials (CORP),lb,-235,$0.33,"23,139"
09/08/2017,SO 22897,2,A1,Inventory - Raw Materials (CORP),lb,-335,$0.33,"22,804"
09/09/2017,SO 22899,2,A1,Inventory - Raw Materials (CORP),lb,-335,$0.33,"22,469"
09/11/2017,SO 22913,2,A1,Inventory - Raw Materials (CORP),lb,-796,$0.33,"21,673"
09/11/2017,SO 22915,2,A1,Inventory - Raw Materials (CORP),lb,-796,$0.33,"20,877"
09/11/2017,SO 22919,2,A1,Inventory - Raw Materials (CORP),lb,-796,$0.33,"20,081"
09/12/2017,SO 22922,2,A1,Inventory - Raw Materials (CORP),lb,-796,$0.33,"19,285"
09/12/2017,SO 22938,2,A1,Inventory - Raw Materials (CORP),lb,-785,$0.33,"18,500"
09/12/2017,SO 22942,2,A1,Inventory - Raw Materials (CORP),lb,-695,$0.33,"17,805"
09/12/2017,SO 22949,2,A1,Inventory - Raw Materials (CORP),lb,-785,$0.33,"17,020"
09/13/2017,SO 22951,2,A1,Inventory - Raw Materials (CORP),lb,-695,$0.33,"16,325"
09/13/2017,SO 22965,2,A1,Inventory - Raw Materials (CORP),lb,-335,$0.33,"15,990"
09/13/2017,SO 22967,2,A1,Inventory - Raw Materials (CORP),lb,-335,$0.33,"15,655"
09/13/2017,SO 22970,2,A1,Inventory - Raw Materials (CORP),lb,-335,$0.33,"15,320"
09/14/2017,SO 22972,2,A1,Inventory - Raw Materials (CORP),lb,-335,$0.33,"14,985"
09/14/2017,SO 22989,2,A1,Inventory - Raw Materials (CORP),lb,-796,$0.33,"14,189"
09/15/2017,SO 22997,2,A1,Inventory - Raw Materials (CORP),lb,-796,$0.33,"13,393"
09/17/2017,SO 23015,2,A1,Inventory - Raw Materials (CORP),lb,-695,$0.33,"12,698"
09/17/2017,SO 23027,2,A1,Inventory - Raw Materials (CORP),lb,-695,$0.33,"12,003"
09/18/2017,SO 23024,2,A1,Inventory - Raw Materials (CORP),lb,-335,$0.33,"11,668"
09/18/2017,SO 23031,2,A1,Inventory - Raw Materials (CORP),lb,-335,$0.33,"11,333"
09/18/2017,SO 23034,2,A1,Inventory - Raw Materials (CORP),lb,-335,$0.33,"10,998"
09/19/2017,SO 23036,2,A1,Inventory - Raw Materials (CORP),lb,-335,$0.33,"10,663"
09/20/2017,SO 23069,2,A1,Inventory - Raw Materials (CORP),lb,-796,$0.33,"9,867"
09/20/2017,SO 23079,2,A1,Inventory - Raw Materials (CORP),lb,-796,$0.33,"9,071"
09/20/2017,SO 23082,2,A1,Inventory - Raw Materials (CORP),lb,-796,$0.33,"8,275"
09/21/2017,SO 23084,2,A1,Inventory - Raw Materials (CORP),lb,-796,$0.33,"7,479"
09/21/2017,SO 23092,2,A1,Inventory - Raw Materials (CORP),lb,-335,$0.33,"7,144"
09/21/2017,SO 23097,3,A1,Inventory - Raw Materials (CORP),lb,-335,$0.33,"6,809"
09/21/2017,SO 23099,2,A1,Inventory - Raw Materials (CORP),lb,-335,$0.33,"6,474"
09/22/2017,SO 23102,2,A1,Inventory - Raw Materials (CORP),lb,-335,$0.33,"6,139"
09/22/2017,SO 23107,2,A1,Inventory - Raw Materials (CORP),lb,-759,$0.33,"5,380"
09/24/2017,SO 23113,2,A1,Inventory - Raw Materials (CORP),lb,-695,$0.33,"4,685"
09/25/2017,SO 23114,2,A1,Inventory - Raw Materials (CORP),lb,-695,$0.33,"3,990"
09/25/2017,SO 23148,2,A1,Inventory - Raw Materials (CORP),lb,-796,$0.33,"3,194"
09/25/2017,SO 23151,2,A1,Inventory - Raw Materials (CORP),lb,-796,$0.33,"2,398"
09/25/2017,SO 23153,2,A1,Inventory - Raw Materials (CORP),lb,-796,$0.33,"1,602"
09/26/2017,SO 23157,2,A1,Inventory - Raw Materials (CORP),lb,-669,$0.33,933
09/26/2017,SO 23158,1,A1,Inventory - Raw Materials (CORP),lb,-127,$0.33,806
09/26/2017,SO 23160,2,A1,Inventory - Raw Materials (CORP),lb,-335,$0.33,471
09/26/2017,SO 23162,2,A1,Inventory - Raw Materials (CORP),lb,-335,$0.33,136
09/26/2017,SO 23164,2,A1,Inventory - Raw Materials (CORP),lb,-136,$0.33,
09/26/2017,PU 10512,1,A1,Country Malt Group,lb,"46,920",$0.03,"46,920"
09/26/2017,SO 23206,2,A1,Inventory - Raw Materials (CORP),lb,-335,$0.03,"46,585"
09/27/2017,SO 23200,2,A1,Inventory - Raw Materials (CORP),lb,-796,$0.03,"45,789"
09/28/2017,SO 23204,2,A1,Inventory - Raw Materials (CORP),lb,-796,$0.03,"44,993"
09/28/2017,SO 23220,2,A1,Inventory - Raw Materials (CORP),lb,-335,$0.03,"44,658"
09/29/2017,SO 23230,2,A1,Inventory - Raw Materials (CORP),lb,-335,$0.03,"44,323"
09/30/2017,SO 23238,2,A1,Inventory - Raw Materials (CORP),lb,-695,$0.03,"43,628"
10/01/2017,SO 23240,2,A1,Inventory - Raw Materials (CORP),lb,-695,$0.03,"42,933"
10/02/2017,SO 23249,2,A1,Inventory - Raw Materials (CORP),lb,-796,$0.03,"42,137"
10/02/2017,SO 23252,2,A1,Inventory - Raw Materials (CORP),lb,-796,$0.03,"41,341"
10/03/2017,SO 23254,2,A1,Inventory - Raw Materials (CORP),lb,-796,$0.03,"40,545"
10/03/2017,SO 23256,2,A1,Inventory - Raw Materials (CORP),lb,-796,$0.03,"39,749"
10/04/2017,SO 23267,2,A1,Inventory - Raw Materials (CORP),lb,-335,$0.03,"39,414"
10/04/2017,SO 23271,2,A1,Inventory - Raw Materials (CORP),lb,-335,$0.03,"39,079"
10/04/2017,SO 23273,2,A1,Inventory - Raw Materials (CORP),lb,-335,$0.03,"38,744"
10/04/2017,SO 23277,2,A1,Inventory - Raw Materials (CORP),lb,-335,$0.03,"38,409"
10/05/2017,SO 23280,2,A1,Inventory - Raw Materials (CORP),lb,-482,$0.03,"37,927"
10/05/2017,SO 23288,2,A1,Inventory - Raw Materials (CORP),lb,-482,$0.03,"37,445"
10/05/2017,SO 23290,2,A1,Inventory - Raw Materials (CORP),lb,-482,$0.03,"36,963"
10/06/2017,SO 23294,2,A1,Inventory - Raw Materials (CORP),lb,-482,$0.03,"36,481"
10/09/2017,SO 23306,2,A1,Inventory - Raw Materials (CORP),lb,-796,$0.03,"35,685"
10/09/2017,SO 23308,2,A1,Inventory - Raw Materials (CORP),lb,-796,$0.03,"34,889"
10/09/2017,SO 23347,1,A1,Inventory - Raw Materials (CORP),lb,-796,$0.03,"34,093"
10/09/2017,SO 23351,2,A1,Inventory - Raw Materials (CORP),lb,-796,$0.03,"33,297"
10/10/2017,SO 23355,2,A1,Inventory - Raw Materials (CORP),lb,-335,$0.03,"32,962"
10/10/2017,SO 23369,2,A1,Inventory - Raw Materials (CORP),lb,-335,$0.03,"32,627"
10/10/2017,SO 23372,2,A1,Inventory - Raw Materials (CORP),lb,-335,$0.03,"32,292"
10/10/2017,SO 23378,2,A1,Inventory - Raw Materials (CORP),lb,-335,$0.03,"31,957"
10/12/2017,SO 23405,2,A1,Inventory - Raw Materials (CORP),lb,-695,$0.03,"31,262"
10/12/2017,SO 23419,3,A1,Inventory - Raw Materials (CORP),lb,-695,$0.03,"30,567"
10/16/2017,SO 23456,2,A1,Inventory - Raw Materials (CORP),lb,-335,$0.03,"30,232"
10/16/2017,SO 23458,2,A1,Inventory - Raw Materials (CORP),lb,-335,$0.03,"29,897"
10/16/2017,SO 23460,2,A1,Inventory - Raw Materials (CORP),lb,-335,$0.03,"29,562"
10/17/2017,SO 23462,2,A1,Inventory - Raw Materials (CORP),lb,-335,$0.03,"29,227"
10/17/2017,SO 23474,2,A1,Inventory - Raw Materials (CORP),lb,-335,$0.03,"28,892"
10/17/2017,SO 23480,2,A1,Inventory - Raw Materials (CORP),lb,-335,$0.03,"28,557"
10/17/2017,SO 23482,2,A1,Inventory - Raw Materials (CORP),lb,-335,$0.03,"28,222"
10/18/2017,SO 23486,2,A1,Inventory - Raw Materials (CORP),lb,-335,$0.03,"27,887"
10/18/2017,SO 23488,2,A1,Inventory - Raw Materials (CORP),lb,-695,$0.03,"27,192"
10/18/2017,SO 23501,1,A1,Inventory - Raw Materials (CORP),lb,-771,$0.03,"26,421"
10/18/2017,SO 23503,2,A1,Inventory - Raw Materials (CORP),lb,-695,$0.03,"25,726"
10/19/2017,SO 23506,1,A1,Inventory - Raw Materials (CORP),lb,-771,$0.03,"24,955"
10/19/2017,SO 23520,2,A1,Inventory - Raw Materials (CORP),lb,-476,$0.03,"24,479"
10/19/2017,SO 23525,2,A1,Inventory - Raw Materials (CORP),lb,-476,$0.03,"24,003"
10/20/2017,SO 23528,2,A1,Inventory - Raw Materials (CORP),lb,-796,$0.03,"23,207"
10/20/2017,SO 23538,2,A1,Inventory - Raw Materials (CORP),lb,-796,$0.03,"22,411"
10/20/2017,SO 23541,2,A1,Inventory - Raw Materials (CORP),lb,-796,$0.03,"21,615"
10/21/2017,SO 23544,2,A1,Inventory - Raw Materials (CORP),lb,-796,$0.03,"20,819"
10/23/2017,SO 23549,2,A1,Inventory - Raw Materials (CORP),lb,-695,$0.03,"20,124"
10/23/2017,SO 23561,2,A1,Inventory - Raw Materials (CORP),lb,-695,$0.03,"19,429"
10/23/2017,SO 23563,2,A1,Inventory - Raw Materials (CORP),lb,-796,$0.03,"18,633"
10/23/2017,SO 23566,2,A1,Inventory - Raw Materials (CORP),lb,-796,$0.03,"17,837"
10/24/2017,SO 23571,2,A1,Inventory - Raw Materials (CORP),lb,-796,$0.03,"17,041"
10/24/2017,SO 23573,2,A1,Inventory - Raw Materials (CORP),lb,-796,$0.03,"16,245"
10/25/2017,SO 23581,2,A1,Inventory - Raw Materials (CORP),lb,-335,$0.03,"15,910"
10/25/2017,SO 23583,2,A1,Inventory - Raw Materials (CORP),lb,-335,$0.03,"15,575"
10/25/2017,SO 23608,1,A1,Inventory - Raw Materials (CORP),lb,-335,$0.03,"15,240"
10/25/2017,SO 23611,2,A1,Inventory - Raw Materials (CORP),lb,-335,$0.03,"14,905"
10/26/2017,SO 23613,1,A1,Inventory - Raw Materials (CORP),lb,-797,$0.03,"14,108"
10/26/2017,SO 23616,2,A1,Inventory - Raw Materials (CORP),lb,-335,$0.03,"13,773"
10/26/2017,SO 23618,2,A1,Inventory - Raw Materials (CORP),lb,-796,$0.03,"12,977"
10/26/2017,SO 23621,2,A1,Inventory - Raw Materials (CORP),lb,-335,$0.03,"12,642"
10/27/2017,SO 23623,2,A1,Inventory - Raw Materials (CORP),lb,-796,$0.03,"11,846"
10/30/2017,SO 23633,2,A1,Inventory - Raw Materials (CORP),lb,-695,$0.03,"11,151"
10/30/2017,SO 23642,2,A1,Inventory - Raw Materials (CORP),lb,-695,$0.03,"10,456"
10/31/2017,SO 23651,2,A1,Inventory - Raw Materials (CORP),lb,-796,$0.03,"9,660"
10/31/2017,SO 23666,2,A1,Inventory - Raw Materials (CORP),lb,-796,$0.03,"8,864"
10/31/2017,SO 23668,2,A1,Inventory - Raw Materials (CORP),lb,-796,$0.03,"8,068"
10/31/2017,SO 23670,2,A1,Inventory - Raw Materials (CORP),lb,-796,$0.03,"7,272"
11/01/2017,SO 23674,2,A1,Inventory - Raw Materials (CORP),lb,-335,$0.03,"6,937"
11/01/2017,SO 23683,2,A1,Inventory - Raw Materials (CORP),lb,-335,$0.03,"6,602"
11/01/2017,PD 10237,1,A1,Country Malt Group,lb,"49,640",$0.00,"56,242"
11/01/2017,SO 23688,2,A1,Inventory - Raw Materials (CORP),lb,-335,$0.00,"55,907"
11/01/2017,SO 23692,2,A1,Inventory - Raw Materials (CORP),lb,-335,$0.00,"55,572"
11/01/2017,PU 10557,1,A1,Country Malt Group,lb,,$0.33,"55,572"
11/02/2017,SO 23704,2,A1,Inventory - Raw Materials (CORP),lb,"-1,398",$0.00,"54,174"
11/02/2017,SO 23706,2,A1,Inventory - Raw Materials (CORP),lb,"-1,398",$0.00,"52,776"
11/03/2017,SO 23708,2,A1,Inventory - Raw Materials (CORP),lb,-335,$0.00,"52,441"
11/03/2017,SO 23710,2,A1,Inventory - Raw Materials (CORP),lb,-796,$0.00,"51,645"
11/03/2017,SO 23722,2,A1,Inventory - Raw Materials (CORP),lb,-335,$0.00,"51,310"
11/03/2017,SO 23726,2,A1,Inventory - Raw Materials (CORP),lb,-796,$0.00,"50,514"
11/06/2017,SO 23730,2,A1,Inventory - Raw Materials (CORP),lb,-335,$0.00,"50,179"
11/06/2017,SO 23747,2,A1,Inventory - Raw Materials (CORP),lb,-335,$0.00,"49,844"
11/06/2017,SO 23752,2,A1,Inventory - Raw Materials (CORP),lb,-204,$0.00,"49,640"
11/06/2017,SO 23752,3,A1,Inventory - Raw Materials (CORP),lb,-131,$0.00,"49,509"
11/06/2017,SO 23755,2,A1,Inventory - Raw Materials (CORP),lb,-335,$0.00,"49,174"
11/07/2017,SO 23758,2,A1,Inventory - Raw Materials (CORP),lb,-695,$0.00,"48,479"
11/07/2017,SO 23770,2,A1,Inventory - Raw Materials (CORP),lb,-695,$0.00,"47,784"
11/07/2017,SO 23772,2,A1,Inventory - Raw Materials (CORP),lb,-796,$0.00,"46,988"
11/07/2017,SO 23774,2,A1,Inventory - Raw Materials (CORP),lb,-796,$0.00,"46,192"
11/08/2017,SO 23776,2,A1,Inventory - Raw Materials (CORP),lb,-796,$0.00,"45,396"
11/08/2017,SO 23786,2,A1,Inventory - Raw Materials (CORP),lb,-796,$0.00,"44,600"
11/09/2017,SO 23797,2,A1,Inventory - Raw Materials (CORP),lb,-813,$0.00,"43,787"
11/09/2017,SO 23808,2,A1,Inventory - Raw Materials (CORP),lb,-813,$0.00,"42,974"
11/09/2017,SO 23810,2,A1,Inventory - Raw Materials (CORP),lb,"-1,398",$0.00,"41,576"
11/10/2017,SO 23816,2,A1,Inventory - Raw Materials (CORP),lb,"-1,398",$0.00,"40,178"
11/12/2017,SO 23836,2,A1,Inventory - Raw Materials (CORP),lb,-695,$0.00,"39,483"
11/13/2017,SO 23839,2,A1,Inventory - Raw Materials (CORP),lb,-695,$0.00,"38,788"
11/13/2017,SO 23849,2,A1,Inventory - Raw Materials (CORP),lb,-796,$0.00,"37,992"
11/13/2017,SO 23853,2,A1,Inventory - Raw Materials (CORP),lb,-796,$0.00,"37,196"
11/14/2017,SO 23857,2,A1,Inventory - Raw Materials (CORP),lb,-796,$0.00,"36,400"
11/14/2017,SO 23871,2,A1,Inventory - Raw Materials (CORP),lb,-796,$0.00,"35,604"
11/14/2017,SO 23874,2,A1,Inventory - Raw Materials (CORP),lb,-335,$0.00,"35,269"
11/14/2017,SO 23876,2,A1,Inventory - Raw Materials (CORP),lb,-335,$0.00,"34,934"
11/15/2017,SO 23879,2,A1,Inventory - Raw Materials (CORP),lb,-335,$0.00,"34,599"
11/15/2017,SO 23881,2,A1,Inventory - Raw Materials (CORP),lb,-335,$0.00,"34,264"
11/16/2017,SO 23890,2,A1,Inventory - Raw Materials (CORP),lb,"-1,398",$0.00,"32,866"
11/16/2017,SO 23908,2,A1,Inventory - Raw Materials (CORP),lb,"-1,398",$0.00,"31,468"
11/17/2017,SO 23913,2,A1,Inventory - Raw Materials (CORP),lb,-335,$0.00,"31,133"
11/17/2017,SO 23931,2,A1,Inventory - Raw Materials (CORP),lb,-335,$0.00,"30,798"
11/18/2017,SO 23936,2,A1,Inventory - Raw Materials (CORP),lb,-695,$0.00,"30,103"
11/19/2017,SO 23939,2,A1,Inventory - Raw Materials (CORP),lb,-695,$0.00,"29,408"
11/20/2017,SO 23942,2,A1,Inventory - Raw Materials (CORP),lb,-335,$0.00,"29,073"
11/20/2017,SO 23958,2,A1,Inventory - Raw Materials (CORP),lb,-335,$0.00,"28,738"
11/20/2017,SO 23962,2,A1,Inventory - Raw Materials (CORP),lb,-335,$0.00,"28,403"
11/21/2017,SO 23964,2,A1,Inventory - Raw Materials (CORP),lb,-335,$0.00,"28,068"
11/21/2017,SO 23966,2,A1,Inventory - Raw Materials (CORP),lb,-796,$0.00,"27,272"
11/21/2017,SO 23980,2,A1,Inventory - Raw Materials (CORP),lb,-796,$0.00,"26,476"
11/21/2017,SO 23983,2,A1,Inventory - Raw Materials (CORP),lb,-796,$0.00,"25,680"
11/22/2017,SO 23986,2,A1,Inventory - Raw Materials (CORP),lb,-796,$0.00,"24,884"
11/22/2017,SO 23988,2,A1,Inventory - Raw Materials (CORP),lb,-805,$0.00,"24,079"
11/22/2017,SO 23990,2,A1,Inventory - Raw Materials (CORP),lb,-805,$0.00,"23,274"
11/22/2017,SO 24003,2,A1,Inventory - Raw Materials (CORP),lb,-805,$0.00,"22,469"
11/25/2017,SO 24005,3,A1,Inventory - Raw Materials (CORP),lb,-695,$0.00,"21,774"
11/26/2017,SO 24034,2,A1,Inventory - Raw Materials (CORP),lb,-695,$0.00,"21,079"
11/27/2017,SO 24040,2,A1,Inventory - Raw Materials (CORP),lb,-796,$0.00,"20,283"
11/27/2017,SO 24041,2,A1,Inventory - Raw Materials (CORP),lb,-796,$0.00,"19,487"
11/27/2017,SO 24042,2,A1,Inventory - Raw Materials (CORP),lb,-796,$0.00,"18,691"
11/28/2017,SO 24046,2,A1,Inventory - Raw Materials (CORP),lb,-796,$0.00,"17,895"
11/28/2017,SO 24049,2,A1,Inventory - Raw Materials (CORP),lb,-805,$0.00,"17,090"
11/28/2017,SO 24071,2,A1,Inventory - Raw Materials (CORP),lb,-824,$0.00,"16,266"
11/28/2017,SO 24072,2,A1,Inventory - Raw Materials (CORP),lb,-352,$0.00,"15,914"
11/29/2017,SO 24069,2,A1,Inventory - Raw Materials (CORP),lb,-352,$0.00,"15,562"
11/29/2017,SO 24078,2,A1,Inventory - Raw Materials (CORP),lb,-352,$0.00,"15,210"
11/29/2017,SO 24081,2,A1,Inventory - Raw Materials (CORP),lb,-352,$0.00,"14,858"
12/01/2017,SO 24097,2,A1,Inventory - Raw Materials (CORP),lb,-805,$0.00,"14,053"
12/01/2017,SO 24099,2,A1,Inventory - Raw Materials (CORP),lb,-695,$0.00,"13,358"
12/01/2017,SO 24115,2,A1,Inventory - Raw Materials (CORP),lb,-805,$0.00,"12,553"
12/01/2017,SO 24117,2,A1,Inventory - Raw Materials (CORP),lb,-695,$0.33,"11,858"
12/03/2017,SO 24121,2,A1,Inventory - Raw Materials (CORP),lb,-335,$0.33,"11,523"
12/04/2017,SO 24124,2,A1,Inventory - Raw Materials (CORP),lb,-335,$0.33,"11,188"
12/04/2017,SO 24133,2,A1,Inventory - Raw Materials (CORP),lb,-796,$0.33,"10,392"
12/04/2017,SO 24136,2,A1,Inventory - Raw Materials (CORP),lb,-796,$0.33,"9,596"
12/04/2017,SO 24139,2,A1,Inventory - Raw Materials (CORP),lb,-796,$0.33,"8,800"
12/05/2017,SO 24142,2,A1,Inventory - Raw Materials (CORP),lb,-796,$0.33,"8,004"
12/05/2017,SO 24163,2,A1,Inventory - Raw Materials (CORP),lb,-335,$0.33,"7,669"
12/06/2017,SO 24165,2,A1,Inventory - Raw Materials (CORP),lb,-335,$0.33,"7,334"
12/06/2017,SO 24187,2,A1,Inventory - Raw Materials (CORP),lb,-335,$0.33,"6,999"
12/06/2017,SO 24189,2,A1,Inventory - Raw Materials (CORP),lb,-335,$0.33,"6,664"
12/06/2017,SO 24192,2,A1,Inventory - Raw Materials (CORP),lb,-796,$0.33,"5,868"
12/07/2017,SO 24195,2,A1,Inventory - Raw Materials (CORP),lb,-805,$0.33,"5,063"
12/07/2017,SO 24216,2,A1,Inventory - Raw Materials (CORP),lb,-796,$0.33,"4,267"
12/07/2017,SO 24228,2,A1,Inventory - Raw Materials (CORP),lb,-805,$0.33,"3,462"
12/08/2017,SO 24230,2,A1,Inventory - Raw Materials (CORP),lb,"-1,398",$0.33,"2,064"
12/08/2017,SO 24250,2,A1,Inventory - Raw Materials (CORP),lb,-641,$0.33,"1,423"
12/11/2017,ST 162,2,A1,Inventory - Raw Materials (CORP),lb,"-1,423",$0.33,
12/12/2017,PD 10260,1,A1,Brewer's Supply Group,lb,"48,840",$0.00,"48,840"
12/12/2017,PU 10572,1,A1,Brewer's Supply Group,lb,,$0.31,"48,840"
12/13/2017,SO 24264,2,A1,WIP - Wort (CORP),lb,-335,$0.00,"48,505"
12/13/2017,SO 24267,2,A1,WIP - Wort (CORP),lb,-335,$0.00,"48,170"
12/13/2017,SO 24281,2,A1,WIP - Wort (CORP),lb,-335,$0.00,"47,835"
12/13/2017,SO 24283,2,A1,WIP - Wort (CORP),lb,-335,$0.00,"47,500"
12/14/2017,SO 24287,2,A1,WIP - Wort (CORP),lb,-796,$0.00,"46,704"
12/14/2017,SO 24289,2,A1,WIP - Wort (CORP),lb,-796,$0.00,"45,908"
12/14/2017,SO 24301,2,A1,WIP - Wort (CORP),lb,-796,$0.00,"45,112"
12/14/2017,SO 24304,2,A1,WIP - Wort (CORP),lb,-796,$0.00,"44,316"
12/15/2017,SO 24306,2,A1,WIP - Wort (CORP),lb,"-1,097",$0.00,"43,219"
12/15/2017,SO 24308,2,A1,WIP - Wort (CORP),lb,"-1,097",$0.00,"42,122"
12/15/2017,SO 24315,2,A1,WIP - Wort (CORP),lb,"-1,097",$0.00,"41,025"
12/16/2017,SO 24317,2,A1,WIP - Wort (CORP),lb,"-1,097",$0.00,"39,928"
12/17/2017,SO 24329,2,A1,WIP - Wort (CORP),lb,-796,$0.00,"39,132"
12/18/2017,SO 24320,2,A1,WIP - Wort (CORP),lb,-796,$0.00,"38,336"
12/18/2017,SO 24327,2,A1,WIP - Wort (CORP),lb,-796,$0.00,"37,540"
12/18/2017,SO 24337,2,A1,WIP - Wort (CORP),lb,-796,$0.00,"36,744"
12/18/2017,SO 24340,2,A1,WIP - Wort (CORP),lb,-335,$0.00,"36,409"
12/19/2017,SO 24342,2,A1,WIP - Wort (CORP),lb,-335,$0.00,"36,074"
12/19/2017,SO 24346,2,A1,WIP - Wort (CORP),lb,-335,$0.00,"35,739"
12/19/2017,SO 24348,2,A1,WIP - Wort (CORP),lb,-335,$0.00,"35,404"
12/21/2017,SO 24375,2,A1,WIP - Wort (CORP),lb,-695,$0.00,"34,709"
12/22/2017,SO 24378,2,A1,WIP - Wort (CORP),lb,"-1,097",$0.00,"33,612"
12/22/2017,SO 24388,2,A1,Inventory - Raw Materials (CORP),lb,"-1,097",$0.31,"32,515"
12/27/2017,SO 24397,3,A1,Inventory - Raw Materials (CORP),lb,-796,$0.31,"31,719"
12/27/2017,SO 24404,2,A1,Inventory - Raw Materials (CORP),lb,-796,$0.31,"30,923"
12/27/2017,SO 24410,2,A1,Inventory - Raw Materials (CORP),lb,-796,$0.31,"30,127"
12/27/2017,SO 24412,2,A1,Inventory - Raw Materials (CORP),lb,-796,$0.31,"29,331"
12/28/2017,SO 24421,2,A1,Inventory - Raw Materials (CORP),lb,-335,$0.31,"28,996"
12/28/2017,SO 24423,2,A1,Inventory - Raw Materials (CORP),lb,-335,$0.31,"28,661"
12/28/2017,SO 24425,2,A1,Inventory - Raw Materials (CORP),lb,-335,$0.31,"28,326"
12/29/2017,SO 24431,2,A1,Inventory - Raw Materials (CORP),lb,-335,$0.31,"27,991"
12/29/2017,SO 24434,2,A1,Inventory - Raw Materials (CORP),lb,"-1,097",$0.31,"26,894"
12/29/2017,SO 24438,2,A1,Inventory - Raw Materials (CORP),lb,"-1,097",$0.31,"25,797"
12/29/2017,SO 24440,2,A1,Inventory - Raw Materials (CORP),lb,-695,$0.31,"25,102"
12/30/2017,SO 24444,2,A1,Inventory - Raw Materials (CORP),lb,-695,$0.31,"24,407"
,,,,,,,,"24,407"